XXXXXXXXXXXXXXXXXXXX
XXXXXXXXXXXXXXXXXXXX
XXH              CXX
XX  M       M XXXXXX
XXXXXXXXXX    XXXXXX
XXXXXXXXXX     M  XX
D    XX           XX
XX   XX MX  XXXXXXXX
XX       X  XXXXXXXX
XXXXX M XXX       XX
XXH X   XX    M   XX
XX                XX
XX      M   X X   XX
XXXXXXX     X X   XX
XXXXXXX     X X   XX
XXC  XXXXXXXX X   XX
XX      M   X X M XX
XX   XX           XX
XXXXXXXXXXXXXXXXXXXX
XXXXXXXXXXXXXXXXXXXX
