XXXXXXXXXXXXXXXXXXXX
XXXXXXXXXXXXXXXXXXXX
XX  XX   M        XX
XX  XX         M  XX
XX  XX   XXXXC    XX
XX        HXXXX   XX
XX         XX     XX
XX   XX   M   XX  XX
XX   XX       XX  XX
XX     XX      XX XX
XX   M XX      XX XX
XX       XXX M XX XX
XX  XXX  XXX      XX
XX   XXX        M XX
XX M     M XXXX   XX
XX         XXXH   XX
XX  XXX    XXXXXXXXX
XX   CX           XX
XXXXXXXXXX XXXXXXXXX
XXXXXXXXXXDXXXXXXXXX
