XXXXXXXXXXXXXXXXXXXX
XXXXXXXXXXXXXXXXXXXX
XXH    XXXXX     CXX
XX M   XXXXX    M XX
XX     X    M     XX
XX     X      XXXXXX
XX    XXXXX   XXXXXX
XX          M     XX
XX         X      XX
XX  X      X      XX
XX  X      XXXX   XX
XX  X    XXXXXX M XX
XX  XXXXXXH       XX
XX      MXXXX     XX
XX              XXXX
XX   XXXX     M    D
XX M XCXX       XXXX
XX       M        XX
XXXXXXXXXXXXXXXXXXXX
XXXXXXXXXXXXXXXXXXXX
