XXXXXXXXXXXXXXXXXXXX
XXXXXXXXXXXXXXXXXXXX
XX                XX
XX                XX
XX                XX
XX                XX
XX                XX
XX                XX
XX                XX
XX                XX
XX                PD
XX                XX
XX                XX
XX                XX
XX                XX
XX                XX
XX                XX
XX                XX
XXXXXXXXXXXXXXXXXXXX
XXXXXXXXXXXXXXXXXXXX
