XXXXXXXXDXXXXXXXXXXX
XXXXXXXX XXXXXXXXXXX
XX     X X        XX
XX C   X X H      XX
XX     X X      M XX
XX M XXX X        XX
XX     X XXXXXXXX XX
XX     X X   M    XX
XX                XX
XX M XXXXXXXXXXXX XX
XX   X C        M  D
XX   XXXXXXXXXXXX XX
XX                XX
XX   M X X     M  XX
XX     X XXXXXXXX XX
XX     X X        XX
XX M   X X P    M XX
XXH    X X        XX
XXXXXXXX XXXXXXXXXXX
XXXXXXXXDXXXXXXXXXXX