XXXXXXXXXXXXXXXXXXXX
XXXXXXXXXXXXXXXXXXXX
XX   XXXXXXX     CXX
XX   XXXXXXX    M XX
D            M    XX
XXXXX         XXXXXX
XXXXX         XXXXXX
XX    M           XX
XX         M      XX
XX              M XX
XXXXXXXXXX   XX   XX
XXXXXXXXXX   XX   XX
XX           XX   XX
XX M   M     XX   XX
XX           XX M XX
XX   XX      XX    D
XX   XX      XX   XX
XX C XX      XX  HXX
XXXXXXXXXXXXXXXXXXXX
XXXXXXXXXXXXXXXXXXXX
