XXXXXXXXXXXXXXXXDXXX
XXXXXXXXXXXXXXXX XXX
XX P XX           XX
XX   XX           XX
XX   XX         M XX
XX M XX      XX   XX
XX   XX      XX   XX
XX   XX      XX   XX
XX   XXXXX   XX M XX
XX   XXXXX   XX   XX
XX           XX   XX
XX  M   M    XX M XX
XXH          XX   XX
XXXXXXXXXX   XX    D
XXXXXXXXXX   XX   XX
XX                XX
XX C  M    M    M XX
XX                XX
XXXXXXXXXXXXXXXXXXXX
XXXXXXXXXXXXXXXXXXXX